.,.,.,.,.,.,.,.,.,.,.,.,.,.,.,.,.,.,.,.,.,.,.,.,.,.,.,.,.,.,.,.,.,.,.,.,.,.,.,.,.,.,.,.,.,.,.,.,.,.,.,.,.,.,.,.,.,.,.,.,.,.,.,.,.,.,.,.,.,.,.,.,.,.,.,.,.,.,.,.
.,.,.,.,.,.,.,.,.,.,.,.,.,.,.,.,.,.,.,.,4,.,.,.,.,.,.,.,.,.,4,.,.,.,.,.,.,.,.,.,.,.,.,.,.,.,.,.,.,.,4,.,.,.,.,.,.,.,.,.,.,.,.,.,.,.,.,.,.,.,.,.,.,.,.,.,.,.,.,.
.,.,.,.,.,.,.,.,.,.,#,.,.,.,.,.,.,.,.,.,1,.,.,.,.,.,.,.,.,.,1,.,.,.,.,.,.,.,.,.,.,.,.,.,.,.,.,.,.,.,1,.,.,.,.,.,.,.,.,.,.,.,.,.,.,.,.,.,.,.,.,.,.,.,.,.,.,.,.,.
.,.,.,.,.,.,.,.,.,.,.,.,.,.,.,.,.,.,.,.,1,.,.,.,.,.,.,.,.,.,.,.,.,.,.,.,.,.,.,.,.,.,.,.,.,.,.,.,.,.,.,.,.,.,.,.,.,.,.,.,.,.,.,.,.,1,.,.,.,.,.,.,.,.,.,.,.,.,.,.
.,.,.,.,.,.,.,.,4,.,4,.,4,.,.,.,.,.,.,.,1,.,.,.,.,.,.,.,.,.,4,.,.,.,.,.,.,.,.,.,.,.,.,.,.,.,.,.,4,.,4,.,4,.,.,.,.,.,.,.,.,.,.,.,1,1,.,.,.,.,.,.,.,.,.,.,.,.,.,.
.,.,2,.,.,+,.,.,1,9,1,0,1,.,.,.,.,.,1,.,1,.,.,.,.,.,.,.,1,0,1,#,1,.,.,.,.,.,.,.,.,.,.,.,.,.,.,.,1,2,1,#,1,.,.,.,.,.,.,.,.,.,.,1,1,1,.,.,.,.,.,.,.,.,.,.,.,.,.,.
.,.,.,.,.,.,.,.,.,.,.,.,1,.,.,.,.,.,1,.,1,.,.,.,6,.,.,.,.,.,.,.,1,.,.,.,.,.,.,.,.,.,.,.,.,.,.,.,.,.,.,.,.,.,.,.,.,.,.,.,.,.,1,1,1,1,.,.,.,.,.,.,.,.,.,.,.,.,.,.
.,.,.,.,.,.,.,.,.,.,.,.,1,.,.,.,.,.,1,.,1,.,.,.,1,.,.,.,.,.,.,.,1,.,.,.,.,.,8,.,.,.,.,.,.,.,.,.,.,.,.,.,.,.,.,.,.,.,.,.,.,1,1,1,1,1,.,.,.,.,.,.,.,.,.,.,.,.,.,.
.,.,.,.,.,.,6,.,3,.,.,.,1,.,.,3,.,.,1,.,1,.,.,4,4,4,.,.,.,.,.,.,1,.,.,.,.,.,.,.,.,.,.,.,.,.,.,.,.,.,.,.,.,.,.,6,.,.,6,.,1,1,1,1,1,1,.,.,.,.,7,.,.,.,.,.,.,.,.,.
1,1,1,1,1,1,1,1,1,1,1,1,1,1,1,1,1,1,1,1,1,1,1,1,1,1,1,1,1,1,1,1,1,1,1,1,1,1,1,.,.,.,.,.,1,1,1,1,1,1,1,1,1,1,1,1,1,1,1,1,1,1,1,1,1,1,.,.,.,.,1,1,1,1,1,1,1,1,1,1